44444444
45000004
40000004
41001304
40000004
43000004
40000004
44444444
