44444444
40040004
40341004
40040004
40040004
40000004
40000054
44444444
