44444444
45000004
40000004
41001004
40000004
43300004
40000004
44444444
